77777777777777777
90000000000000008
90102210001220108
90225220302252208
90241400300515208
90444442325555508
90141412321515108
90244420302555208
90224442325555208
90122420302522108
90002242325220008
90101222322210108
90000022322000008
90101000000010108
66666666666666666